w                              w
w                              w
w                              w
w                              w
w                              w
w                              w
w                              w
w                              w
w                              w
w                              w
w                              w
w                   e   www  w w
w                   www     ww w
w  w w w w w  w w w w      www w
w                       ww     w
w s       e     w     wwww     w
w  w      n    www  w          w
wwwwwww wwwwwwwwwwww  wwwwww  ww
