wwwwwwwwwwwwwwwwwwwwwwwwwwwwwwwwwwwwwwwwwwwwwwww
w                                        w     w
w                                        w  n  w
wppp         pp                          w     w
w  pp     pp                                   w
w   pp  p                                      w
w    pppppppplllllllpppplllllppppppppppppp     w
w           ppppppppp  pppppppb                w
w           r                                  w
w                                      s       w
w                                 ppppp        w
w                                      pp      w
w                                           p  w
wppppppppppp ppppppppppppp       ppppppppppppppw
w                                              w
w                                              w
w                                              w
w                                              w
w                                              w
w                     lllllllllllllllll        w
w                                              w
w                                              w
w                                              w
w                                              w
w                                              w
w                                             ew
wwwwwwwwwwww wwwwwwwwwwwwwwwwwwwwwwwwwwwwwwwwwww
